1111111111
1ECP00001
1000000011
1111111111
