1111111111
1ECP000000
1000000001
1111111111
