1111111111
1E0P000001
1000000001
1111111111
