1111111111
1E1P000001
1C100C0001
1111111111
