1111111111
1ECP000001
100000E001
1111111111
