1111111111
1ECP000001
100000P001
1111111111
