1111111111
10CP000001
1000000001
1111111111
