1111111111
100P0010E1
1000001001
1000001001
1C00000001
1111111111
