11111111111111111111
100P0010010000000001
10000010010000000001
100000100100000C0001
1C000000010000000001
10000000000000000001
10000010010000000001
10000010011111110001
10000010010000000001
1C000000010000000001
11111111110000000001
1000000001000C000001
10000010000000000001
10000010010000000001
1C000000010000000001
1C000000011111111111
1C00C000010000000001
1C000000010000000001
1C000000000000000001
1C0000000100000000E1
11111111111111111111
