1111111111
100P0010E1
1C00001001
100C001001
1C000C0001
1111111111
